xxxxxxxxxxxexx
x____________x
x______1_____x
x__________1_x
x_____x______x
x_____x______x
x_____x______x
x____________x
x____________x
x____________x
x____________x
x____________x
x_2__________x
x_________p__x
xxxxxxxxxxxxxx
