xxxxxxxxxxxxxxxxxxxxxxxxxxxxxxxxxxxxxexx
x______________________________________x
x______________________________________x
x______________________________________x
x______________________________________x
x____1_________________________________x
x_________x____________________________x
x______________1_______________________x
x______________________________________x
x__________x______________2____________x
x__________x___________________________x
x__________x___________________________x
x____________________________2_________x
x______________________________________x
x______x_______________2_______________x
x___________p__________________________x
xxxxxxxxxxxxxxxxxxxxxxxxxxxxxxxxxxxxxxxx
