xxxxxxxxxexx
x__________x
x__1_______x
x__________x
x__________x
x__________x
x__________x
x__________x
x__________x
x__________x
x_________px
xxxxxxxxxxxx